Wallet No,DateTime,Transaction Type,Amount,Transaction ID, Balance
1712345678,1/1/2023 12:00,Received Money,1000,#01PJMOKOT4H,11000
1712345678,1/1/2023 12:00,Send Money,200,#01987R8SJFU,10800
1712345678,1/1/2023 12:00,Cash Out,500,#01NSY9KFFTO,10300
1712345678,2/5/2023 13:30,Make Payment,100,#011SYZ1UTZF,10200
1712345678,2/5/2023 13:30,Donation,50,#01U085ZYJMO,10150
1712345678,2/5/2023 13:30,Fund Transfer,1000,#013AP0ASS5E,9150
1712345678,2/15/2023 13:30,Received Money,2000,#016ZFWO25E6,11150
1712345678,3/10/2023 14:00,Cash Out,500,#01KFNMCGFG9,10650
1712345678,3/10/2023 14:00,Add Money,3000,#01B8TFQVSZO,13650
1712345678,3/10/2023 14:00,Request Money,100,,13650
1712345678,9/27/2023 10:44,Received Money,100,#01HG1U38ONH,13750
1712345678,3/20/2023 14:00,Cash In,1000,#01TZDOGQOQJ,14750
1712345678,4/15/2023 15:00,Send Money,200,#013KS29OKRY,14550
1712345678,4/15/2023 15:00,Donation,50,#01MPGJ439OI,14500
1712345678,4/15/2023 15:00,Make Payment,100,#01YR075XW19,14400
1712345678,4/25/2023 15:00,Cash Out,500,#01TA78BUS02,13900
1712345678,5/20/2023 16:00,Add Money,3000,#01A6T3QB58S,16900
1712345678,5/20/2023 16:00,Received Money,1000,#01Y2LL6MQNX,17900
1712345678,5/20/2023 16:00,Send Money,200,#01DHPBXWHJJ,17700
1712345678,5/30/2023 16:00,Send Money,500,#01CYKI17ANA,17200
1712345678,6/4/2023 12:00,Add Money,3000,#016UDHZ695Y,20200
1712345678,6/25/2023 12:30,Request Money,100,,20200
1712345678,9/27/2023 10:44,Received Money,100,#01J15ORKW5R,20300
1712345678,6/25/2023 12:30,Send Money,100,#01581MM7K1X,20200
1712345678,6/25/2023 12:30,Cash In,1000,#01OCA4XG0CT,21200
1712345678,7/8/2023 13:30,Send Money,200,#019HJ1AA3G2,21000
1712345678,7/30/2023 13:00,Cash Out,500,#01H3HLIJA4U,20500
1712345678,7/30/2023 13:00,Make Payment,100,#011D9MW1JIK,20400
1712345678,7/30/2023 13:00,Donation,50,#01GJ4I6HQRL,20350
1712345678,8/4/2023 14:30,Fund Transfer,1000,#01EULP0LOSA,19350
1712345678,8/4/2023 14:30,Received Money,2000,#01H9YOF14QT,21350
1712345678,8/4/2023 14:30,Cash Out,500,#01WHFW5FM3N,20850
1712345678,8/12/2023 14:00,Add Money,3000,#01CFNTV8YW8,23850
1712345678,9/8/2023 15:30,Request Money,500,,23850
1712345678,9/8/2023 15:30,Received Money,1000,#01P0N3ZZTJ1,24850
1712345678,9/8/2023 15:30,Received Money,500,#01SZVLTT3RP,25350
1712345678,9/16/2023 15:00,Cash In,1000,#0144EOYL7FM,26350
1712345678,9/27/2023 10:44,Received Money,600,#01KXXLPR3S9,26950
1712345678,10/12/2023 16:00,Send Money,200,#01M7CJSDAS5,26750
1712345678,10/12/2023 16:00,Cash Out,500,#01KX3E2AWPJ,26250
1712345678,10/12/2023 16:00,Send Money,100,#01MNB6QMZ7D,26150
1712345678,10/20/2023 16:00,Donation,50,#01D2OJGR8QV,26100
1712345678,11/16/2023 12:00,Fund Transfer,1000,#01LWHXFSVMP,25100
1712345678,11/16/2023 12:00,Cash In,2000,#01C3G53BLTT,27100
1712345678,11/16/2023 12:00,Send Money,500,#01G6LBI29DF,26600
1712345678,11/25/2023 12:30,Add Money,3000,#01N2FMDSNTM,29600
1712345678,12/20/2023 13:30,Request Money,850,,29600
1712345678,9/27/2023 10:44,Received Money,300,#01D2LEQLJ4E,29900
1712345678,12/20/2023 13:30,Received Money,1000,#01MKUEPMAWH,30900
1712345678,12/20/2023 13:30,DNCC Holding Tax,500,#01WA6KSMLSW,30400
1887654321,1/5/2023 13:30,Cash In,500,#01NWZSHT94B,1100
1887654321,1/10/2023 14:00,Request Money,300,,1100
1887654321,1/10/2023 14:20,Received Money,300,#01NQ4BK6K7H,1400
1887654321,1/15/2023 15:00,Cash Out,200,#01JY3TAW8E7,1200
1887654321,2/5/2023 13:30,Add Money,1000,#01WZ2KZSJ0V,2200
1887654321,2/10/2023 14:00,Request Money,200,,2200
1887654321,2/10/2023 14:20,Received Money,200,#01CG0N2R5A6,2400
1887654321,2/15/2023 15:00,Cash Out,500,#01HVWPIPZIH,1900
1887654321,3/5/2023 13:30,Cash In,1000,#01CJ8R3RGHQ,2900
1887654321,3/10/2023 14:00,Received Money,100,#018DTCWIZDY,3000
1887654321,3/15/2023 15:00,Send Money,300,#01QJY6VSCTF,2700
1887654321,4/5/2023 13:30,Received Money,200,#01TLBOURE3M,2900
1887654321,4/10/2023 14:00,Cash Out,500,#01717QZY5LM,2400
1887654321,9/27/2023 10:41,Received Money,200,,200
1887654321,4/15/2023 15:00,Cash In,1000,#01KJRJ2A488,3400
1887654321,9/27/2023 10:44,Received Money,200,,200
1887654321,5/5/2023 13:30,Make Payment,100,#01RICLI7JNM,3300
1887654321,5/10/2023 14:00,Send Money,200,#01JLRRYWS4K,3100
1887654321,5/15/2023 15:00,Request Money,100,,3100
1887654321,5/15/2023 15:20,Received Money,100,#01E0TNZXYTB,3200
1887654321,6/5/2023 13:30,Cash In,500,#0145H084FHK,3700
1887654321,6/10/2023 14:00,Send Money,300,#01X21EBZASN,3400
1887654321,6/15/2023 15:00,Request Money,200,,3400
1887654321,6/15/2023 15:20,Received Money,200,#01T5FV1MYGP,3600
1887654321,7/5/2023 13:30,Make Payment,100,#01K20YSXF94,3500
1887654321,7/10/2023 14:00,Cash Out,200,#01T3G84LNQJ,3300
1887654321,7/15/2023 15:00,Cash In,1000,#01GFDVYPIKJ,4300
1887654321,8/5/2023 13:30,Send Money,100,#01N3QAG24VJ,4200
1887654321,9/5/2023 13:30,Request Money,200,,4200
1887654321,9/5/2023 13:30,Received Money,200,#01184HM9FH1,4400
1887654321,9/10/2023 14:00,Pay Bill,100,#01B05Q3VYMX,4300
1887654321,9/15/2023 15:00,Cash In,500,#013FQKZIS42,4800
1887654321,10/5/2023 13:30,Make Payment,200,#01CF41B3V4N,4600
1887654321,10/10/2023 14:00,Donation,50,#01ZICNTGOYN,4550
1887654321,10/15/2023 15:00,Pay Bill,100,#01Y06L6E5WU,4450
1887654321,11/5/2023 13:30,Make Payment,100,#01M2PXHY1CK,4350
1887654321,11/10/2023 14:00,Request Money,300,,4350
1887654321,11/10/2023 14:20,Received Money,300,#01UGJCGSVOP,4650
1887654321,11/15/2023 15:00,Cash In,1000,#017GBIZQWMJ,5650
1887654321,12/5/2023 13:30,Remittance,9500,#01P6KURDEPI,15150
1887654321,12/5/2023 13:50,Send Money,10000,#01P6KURDEPI,5150
1887654321,12/10/2023 14:00,Pay Bill,100,#012SY20T3HZ,5050
1887654321,12/15/2023 15:00,Make Payment,200,#012HALMUWCB,4850
1887654321,12/20/2023 16:00,Request Money,100,,4850
1887654321,12/20/2023 16:40,Received Money,100,#01YB95AF1ZA,4950
1887654321,12/25/2023 17:00,Make Payment,4850,#01IWRPB9BHX,100
1913579246,1/5/2023 10:00,Received Money,10000,#01AWR4HX6B1,47000
1913579246,1/8/2023 14:00,Make Payment,5000,#01OF5XGE7MH,42000
1913579246,1/10/2023 16:00,Pay Bill,10000,#01XKV60V2HE,32000
1913579246,1/13/2023 18:00,Fund Transfer,15000,#01DMZ8PR7A7,17000
1913579246,1/15/2023 10:00,Send Money,2000,#01WCBLYLFIZ,15000
1913579246,1/18/2023 14:00,Make Payment,3000,#01TDMEEAH3I,12000
1913579246,1/20/2023 16:00,Fund Transfer,10000,#01O9R3KGN12,22000
1913579246,1/23/2023 18:00,Fund Transfer,5000,#01QNQ4RDMN2,27000
1913579246,1/25/2023 10:00,Make Payment,1000,#01YPV3GOOV4,26000
1913579246,1/28/2023 14:00,Cash Out,3000,#017QOGZNRV2,23000
1913579246,1/30/2023 16:00,Fund Transfer,10000,#01TYY2T8QKG,33000
1913579246,1/31/2023 18:00,Make Payment,2000,#01KRXBSRFSS,31000
1913579246,2/5/2023 10:00,Received Money,10000,#01G580C0NLC,41000
1913579246,2/8/2023 14:00,Donation,1000,#01QKT2ESLM6,40000
1913579246,2/10/2023 16:00,Pay Bill,2000,#01P8TRCATU5,38000
1913579246,2/13/2023 18:00,Make Payment,5000,#01LEWJTRSZY,33000
1913579246,2/15/2023 10:00,Cash In,15000,#01PK9OL2EEQ,48000
1913579246,2/18/2023 14:00,Donation,500,#01CGJRZ5OUV,47500
1913579246,2/20/2023 16:00,Pay Bill,3000,#014KJVFIOBR,44500
1913579246,2/23/2023 18:00,Make Payment,2000,#01JPYULX92I,42500
1913579246,2/25/2023 10:00,Received Money,20000,#01FSEWB0IOE,62500
1913579246,2/28/2023 14:00,Send Money,1000,#01XUKNZZ9EY,61500
1913579246,2/28/2023 16:00,Pay Bill,1000,#01UV9SN68Q1,60500
1913579246,2/28/2023 18:00,Make Payment,500,#014U281RKDB,60000
1913579246,3/5/2023 10:00,Received Money,10000,#01MNWUXZWN6,70000
1913579246,3/8/2023 14:00,Send Money,1000,#013BDR532UW,69000
1913579246,3/10/2023 16:00,Pay Bill,2000,#01D3BN02R8B,67000
1913579246,3/13/2023 18:00,Donation,500,#01G8B0HMWLL,66500
1913579246,3/15/2023 10:00,Received Money,15000,#017AO8OIGMI,81500
1913579246,3/18/2023 14:00,Send Money,500,#01SUCF6D4MV,81000
1913579246,3/20/2023 16:00,Pay Bill,3000,#01XBF36A3E1,78000
1913579246,3/23/2023 18:00,Donation,1000,#01YZFMAP612,77000
1913579246,3/25/2023 10:00,Send Money,1000,#01R97OO1KJY,76000
1913579246,3/28/2023 14:00,Cash In,20000,#01VDC4E79IT,96000
1913579246,3/30/2023 16:00,Pay Bill,1000,#01XUCGZ94FH,95000
1913579246,4/1/2023 10:00,Send Money,2500,#01666DG04KZ,92500
1913579246,4/5/2023 14:00,Cash In,5000,#01DEAEYIWMG,97500
1913579246,4/10/2023 16:00,Pay Bill,2000,#01VKSOFK1YC,95500
1913579246,5/1/2023 10:00,Donation,1000,#01B5I4JRTN6,94500
1913579246,5/5/2023 14:00,Land Tax,35000,#01X81DGB9P5,59500
1913579246,5/10/2023 16:00,Fund Transfer,1500,#01NMO5KPYPW,58000
1913579246,6/1/2023 10:00,Send Money,3000,#013OVF20QK1,55000
1913579246,6/5/2023 14:00,Received Money,10000,#01ZE7OCW5VJ,65000
1913579246,6/10/2023 16:00,Pay Bill,2500,#0117NLFNIYI,62500
1913579246,6/15/2023 18:00,Donation,1250,#01WTEWQKSEH,61250
1913579246,6/20/2023 10:00,Land Tax,40000,#01KG8NL6YKE,21250
1913579246,6/25/2023 14:00,Fund Transfer,1500,#01HLP9HPVBS,19750
1913579246,7/1/2023 10:00,Received Money,10000,#01VAPDRCCEX,29750
1913579246,7/5/2023 14:00,Pay Bill,2000,#01XR1TT47XJ,27750
1913579246,7/10/2023 16:00,Fund Transfer,1500,#01PAKFI5BFI,26250
1913579246,8/1/2023 10:00,Received Money,15000,#01SWTT4LEGR,41250
1913579246,8/5/2023 14:00,Cash Out,1000,#01GB7NWE66V,40250
1913579246,8/10/2023 16:00,Pay Bill,2500,#010V1CAO1SR,37750
1913579246,9/1/2023 10:00,Cash In,20000,#011UYAAXI4O,57750
1913579246,9/5/2023 14:00,Fund Transfer,2000,#017N7NIR2GS,55750
1913579246,9/10/2023 16:00,Pay Bill,3000,#01HL388Z7C5,52750
1913579246,9/15/2023 18:00,Pay Bill,10000,#01EVGSFPDPL,42750
1913579246,9/20/2023 10:00,Cash In,25000,#016QV6UWOQ0,67750
1913579246,9/25/2023 14:00,Fund Transfer,2500,#012GIRPNQN7,65250
1913579246,9/30/2023 16:00,Pay Bill,3500,#01GA7BME3P8,61750
1913579246,11/1/2023 10:00,Send Money,2000,#012MT7P6LDX,59750
1913579246,11/5/2023 14:00,Received Money,5000,#0101P5VS5LN,64750
1913579246,11/10/2023 16:00,Pay Bill,2500,#01TLJMEIUB0,62250
1913579246,11/15/2023 18:00,Send Money,3000,#01UOVGX07TW,59250
1913579246,11/20/2023 10:00,Donation,1000,#0156N84UZTJ,58250
1913579246,11/25/2023 14:00,Fund Transfer,1500,#01K4AP4QEK7,56750
1913579246,11/30/2023 16:00,Send Money,4000,#01OXD1BW0PF,52750
1913579246,12/1/2023 10:00,Send Money,5000,#01KTSD7ZE73,47750
1913579246,12/5/2023 14:00,Received Money,10000,#014BL6OFCRU,57750
1913579246,12/10/2023 16:00,Pay Bill,3000,#01QW3CIPJ5I,54750
1913579246,12/15/2023 18:00,Send Money,6000,#01YBTAEGXD8,48750
1913579246,12/20/2023 10:00,Donation,1500,#011KD2KUQF1,47250
1913579246,12/25/2023 14:00,Fund Transfer,2000,#011KD2KUQF2,45250
1913579246,12/30/2023 16:00,Send Money,7000,#011KD2KUQF3,38250
1624681012,11/27/2022 17:52,Cash Out,2595.57,#01MDN3GU0LW,1669.88
1624681012,9/30/2022 18:44,Add Money,949.24,#015RXGF88A3,2619.12
1624681012,10/8/2022 23:31,Remittance,21449.28,#01BUTD1D6KY,24068.4
1624681012,10/8/2022 23:35,Send Money,20000,#01BUTD1D6KY,4068.4
1624681012,10/20/2022 16:48,Cash In,574.52,#01UIEVGWEYE,4642.92
1624681012,10/24/2022 15:48,Send Money,3798.87,#01QQUBLIVTD,844.05
1624681012,11/4/2022 23:37,Make Payment,627.21,#012PM5ECISB,216.84
1624681012,11/6/2022 15:51,Cash In,3917.85,#01222CUMX7V,4134.69
1624681012,11/8/2022 10:49,Pay Bill,2020.81,#0150E90WF4I,2113.88
1624681012,11/10/2022 0:40,Add Money,1770.25,#01CCVG4KLZQ,3884.13
1624681012,11/11/2022 17:39,Mobile Recharge,27.57,#01CPPUDPOAO,3911.7
1624681012,11/12/2022 8:31,Cash In,9904.98,#01CQXWJ6R42,13816.68
1624681012,11/14/2022 14:27,Pay Bill,2392.43,#01HQPF6W6FV,11424.25
1624681012,11/21/2022 9:20,Cash In,7242.11,#010XL94AYDO,18666.36
1624681012,11/24/2022 0:14,Make Payment,3407.23,#01T9GPHE9N1,15259.13
1624681012,12/2/2022 21:41,Mobile Recharge,76.89,#01TSISFF9KI,15336.02
1624681012,12/6/2022 3:54,Cash Out,4080.57,#01MWGGPKPUE,11255.45
1624681012,12/7/2022 20:17,Received Money,9876.4,#01U84C40UI2,21131.85
1624681012,12/9/2022 12:08,Send Money,2541.47,#01T93988325,18590.38
1624681012,12/10/2022 17:09,Cash In,1407.52,#01DO5QDZ6XF,19997.9
1624681012,12/17/2022 15:48,Received Money,9051.06,#01CCUOQ4NV1,29048.96
1624681012,12/20/2022 21:19,Add Money,6112.22,#01ZQHW5ESJK,35161.18
1624681012,12/21/2022 13:07,Cash In,2556.06,#01Q3E12DRCX,37717.24
1624681012,12/24/2022 4:56,Received Money,7808.67,#016YBRWQ9IR,45525.91
1624681012,12/27/2022 6:44,Send Money,3143.26,#01XMYYA3HOO,42382.65
1624681012,12/28/2022 4:23,Mobile Recharge,80.33,#01WXLWBTGJR,42462.98
1624681012,12/31/2022 21:03,DNCC Holding Tax,4293.93,#01090H6ZY5Z,38169.05
1624681012,1/6/2023 14:54,Cash In,9811.58,#01H7TC1K8ZZ,47980.63
1624681012,1/9/2023 20:44,Pay Bill,1545.97,#01YXG946870,46434.66
1624681012,1/12/2023 9:15,Add Money,7598.24,#01IYIFP71RX,54032.9
1624681012,1/13/2023 18:43,Make Payment,1765.36,#013B3AQ07D9,52267.54
1624681012,1/13/2023 20:48,Cash Out,1698.66,#010ZFK1083I,50568.88
1624681012,1/14/2023 21:59,Mobile Recharge,42.59,#01CIJMODN7G,50611.47
1624681012,1/16/2023 21:05,Add Money,858.9,#0108V12NED0,51470.37
1624681012,1/23/2023 21:49,Pay Bill,2391.96,#013PGX6YU34,49078.41
1624681012,1/24/2023 13:50,Make Payment,348.55,#01C5B9GFOKS,48729.86
1624681012,1/26/2023 2:25,Add Money,6934.6,#01KQJZWGWCM,55664.46
1624681012,1/26/2023 5:23,Mobile Recharge,159.18,#01PPW5AWCTS,55823.64
1624681012,1/26/2023 12:30,Pay Bill,1153.36,#013HTX6PHHC,54670.28
1624681012,1/27/2023 10:43,Pay Bill,1538.12,#012FWGOS4WM,53132.16
1624681012,2/12/2023 6:25,Send Money,6188.68,#018ECCUXANQ,46943.48
1624681012,2/12/2023 13:42,Cash Out,6327.16,#01X2KH8YT2C,40616.32
1624681012,2/12/2023 14:45,Send Money,1219.29,#01U6E74PRX4,39397.03
1624681012,2/16/2023 9:02,Received Money,5900.91,#010KQ7SQ5I0,45297.94
1624681012,2/19/2023 8:35,Add Money,8367.9,#01POECW3MN9,53665.84
1624681012,2/20/2023 4:50,Pay Bill,824.02,#010KFG7FNH4,52841.82
1624681012,2/23/2023 10:58,Cash Out,6112.11,#01YZFZO42KT,46729.71
1624681012,2/25/2023 12:47,Received Money,2076.13,#01TK5D7R4H6,48805.84
1624681012,2/28/2023 1:52,Make Payment,843.91,#01PFONTXYSN,47961.93
1624681012,3/1/2023 12:45,Cash In,2091.83,#01JF43BVAMO,50053.76
1624681012,3/3/2023 9:22,Received Money,6563.83,#01V3LG2PKKQ,56617.59
1624681012,3/3/2023 17:51,Land Tax,3029.17,#0124QE2ARLA,53588.42
1624681012,3/4/2023 22:56,Cash In,9213.85,#019Y1CFCVY0,62802.27
1624681012,3/21/2023 14:19,Received Money,3942.02,#01RKYFTHALJ,66744.29
1624681012,3/22/2023 22:40,Received Money,5379.8,#017MWRB62JE,72124.09
1624681012,3/23/2023 12:32,Cash Out,4467.35,#013HPMTYR4B,67656.74
1624681012,3/25/2023 22:09,Received Money,8000,#01BQIB6XPPA,75656.74
1624681012,3/29/2023 12:15,Received Money,5606,#01PUHVWOEIL,81262.74
1624681012,3/31/2023 13:57,Add Money,8914.32,#018W0NHTN84,90177.06
1624681012,4/1/2023 22:36,Send Money,5401.42,#01GQIJCF4SQ,84775.64
1624681012,4/7/2023 1:56,Pay Bill,2304.16,#018CCT88JHO,82471.48
1624681012,4/9/2023 5:31,Make Payment,10005.99,#018WTUWDIS2,72465.49
1624681012,4/9/2023 17:14,Pay Bill,37063.64,#010KHYTOZQU,35401.85
1624681012,4/15/2023 4:50,Make Payment,1004.1,#01AOCRQ90UR,34397.75
1624681012,4/21/2023 15:31,Cash In,1391.31,#01O9K0MJHSQ,35789.06
1624681012,5/6/2023 14:16,Received Money,8011.08,#01WT974ZD2G,43800.14
1624681012,5/8/2023 21:28,Pay Bill,1427.51,#01FWPW0T7JT,42372.63
1624681012,5/22/2023 17:18,Add Money,5071.27,#012RTHQT77U,47443.9
1624681012,5/22/2023 22:47,Add Money,4893.27,#01EE6WLR8YA,52337.17
1624681012,5/22/2023 23:57,Cash Out,7655.25,#016RKBX5VMF,44681.92
1624681012,6/7/2023 8:31,Add Money,1301.56,#0168DLCLO4X,45983.48
1624681012,6/12/2023 16:23,Received Money,7585.91,#01V6SN28IS5,53569.39
1624681012,6/14/2023 2:41,Cash Out,1969.07,#01MI85M83TX,51600.32
1624681012,6/19/2023 1:34,Cash Out,3664.79,#01TA8M58OJP,47935.53
1624681012,6/20/2023 4:21,Received Money,1627.34,#01SJ9STNDET,49562.87
1624681012,6/21/2023 16:04,Add Money,5256.53,#01SDR8GQIYL,54819.4
1624681012,6/22/2023 13:03,Received Money,1639.68,#014O49IG2TS,56459.08
1624681012,7/3/2023 11:27,Cash Out,1917.79,#01JU9J357K5,54541.29
1624681012,7/11/2023 3:06,Make Payment,2073.9,#014OJEVYRCT,52467.39
1624681012,7/11/2023 15:47,Cash Out,7602.17,#01G0KVCYFZM,44865.22
1624681012,7/25/2023 7:14,Cash Out,1765.16,#018B3DBRI78,43100.06
1624681012,7/26/2023 12:04,Add Money,3890.11,#01B2O1WQ2P8,46990.17
1624681012,7/29/2023 9:57,Received Money,897.77,#01FB2QS3I51,47887.94
1624681012,7/30/2023 14:35,Received Money,1463.38,#013WLSFQNWB,49351.32
1624681012,8/1/2023 13:02,Cash In,5948.79,#01KU320LFB3,55300.11
1624681012,8/13/2023 17:27,Received Money,6463.88,#0110RF29DIH,61763.99
1624681012,8/26/2023 9:11,Cash Out,4381.13,#01MV8V3N9CC,57382.86
1624681012,9/2/2023 6:31,Send Money,606.48,#016EUF6K7EI,56776.38
1624681012,9/3/2023 13:39,Send Money,6802.35,#01CSWSPS6KH,49974.03
1624681012,9/6/2023 19:13,Pay Bill,1100.31,#01VN57R93DY,48873.72
1624681012,9/7/2023 19:16,Mobile Recharge,131.34,#01S68EIG9HJ,49005.06
1624681012,9/12/2023 0:33,Cash In,601.97,#01IZM378R0T,49607.03
1624681012,9/14/2023 5:21,Make Payment,295.18,#01H2KPJUZ1H,49311.85
1624681012,9/14/2023 21:31,Cash In,8235.45,#01WEUBGXLJG,57547.3
1597531864,9/29/2022 11:18,Received Money,1000,#01W4GXFLG1E,2000
1597531864,10/1/2022 18:34,Cash In,1399.62,#01D4GXKLG1H,3399.62
1597531864,10/4/2022 19:48,Received Money,716.34,#01BF1T76CP8,4115.96
1597531864,10/19/2022 7:34,Cash Out,1762.47,#019ROLDYP29,2353.49
1597531864,10/21/2022 17:13,Cash In,1707.52,#015ZMH0EYV1,4061.01
1597531864,10/22/2022 9:33,Send Money,1369.8,#01D2T81JV7F,2691.21
1597531864,10/22/2022 20:13,Send Money,1775.42,#01VWWCXDGF7,915.79
1597531864,10/24/2022 14:59,Received Money,599.95,#0175FA1UI1V,1515.74
1597531864,10/28/2022 2:09,Add Money,158.24,#01LHC7N55RV,1673.98
1597531864,11/7/2022 12:43,Received Money,738.78,#017JVI3M3AA,2412.76
1597531864,11/27/2022 10:00,Cash In,422.57,#01SH600GSHG,2835.33
1597531864,11/29/2022 9:11,Send Money,979.78,#01R0TTRYSWN,1855.55
1597531864,12/7/2022 17:01,Add Money,1399.11,#01LQLDZNNNI,3254.66
1597531864,12/18/2022 17:41,Received Money,1361.01,#017ZWH81EMY,4615.67
1597531864,12/20/2022 20:07,Pay Bill,216.53,#01EA9GQ9WNX,4399.14
1597531864,12/24/2022 1:31,Request Money,116.09,,4399.14
1597531864,12/25/2022 14:10,Add Money,1142.55,#01H5DOL0DUY,5541.69
1597531864,12/25/2022 14:30,Received Money,116.09,#01MQGN4RLIR,5657.78
1597531864,12/31/2022 22:22,Cash Out,1913.58,#01CCBZHW2RT,3744.2
1597531864,1/3/2023 15:18,Send Money,697.43,#01P73RASXFV,3046.77
1597531864,1/6/2023 7:01,Cash Out,1259.53,#01N0L78MOEK,1787.24
1597531864,1/14/2023 9:13,Received Money,1369.87,#01OW8K014U1,3157.11
1597531864,2/5/2023 20:51,Cash In,641.97,#01RT34PDK1J,3799.08
1597531864,2/16/2023 17:44,Received Money,334.55,#01IVPCAP556,4133.63
1597531864,2/23/2023 13:49,Add Money,500,#01S7S08F2W5,4633.63
1597531864,2/24/2023 14:44,Received Money,200,#0136R2KLHTX,4833.63
1597531864,2/25/2023 0:29,Send Money,1601.71,#01YZQH8Z4XO,3231.92
1597531864,3/9/2023 3:39,Add Money,1572.4,#01JPJ5YMFIF,4804.32
1597531864,3/10/2023 16:05,Received Money,1400.9,#017OZSHBWHE,6205.22
1597531864,3/29/2023 1:49,Cash Out,1487.44,#01N58NODB3P,4717.78
1597531864,3/30/2023 7:55,Add Money,546.94,#01EPRG03CDW,5264.72
1597531864,4/10/2023 9:00,Send Money,1934.5,#01GEH5EIXNC,3330.22
1597531864,4/13/2023 19:24,Pay Bill,216.29,#01ZZRSZ080Q,3113.93
1597531864,5/2/2023 17:44,Send Money,859.87,#01Z2J3GQYQN,2254.06
1597531864,5/24/2023 11:25,Cash Out,608.71,#01BTD2GQVWM,1645.35
1597531864,5/26/2023 19:46,Donation,186.33,#01TZJKFJTNT,1459.02
1597531864,5/30/2023 7:51,Received Money,739.68,#01DRGWIP0ES,2198.7
1597531864,6/6/2023 12:16,Received Money,800.48,#012QVL8BWMO,2999.18
1597531864,6/9/2023 8:18,Received Money,209.34,#01GOMOWJWXI,3208.52
1597531864,6/12/2023 4:56,Cash In,502.56,#01BPP06KXUW,3711.08
1597531864,6/17/2023 13:41,Received Money,589.42,#01L9RQEG80J,4300.5
1597531864,6/21/2023 20:16,Add Money,1500.66,#01Z1P1GON9J,5801.16
1597531864,6/23/2023 9:11,Cash Out,673.36,#013E7OPGGK6,5127.8
1597531864,6/28/2023 8:56,Send Money,1345.99,#01ABFJPLVMY,3781.81
1597531864,7/2/2023 1:31,Cash Out,1255.94,#01A2R9PU6E3,2525.87
1597531864,7/4/2023 16:11,Send Money,509.91,#017SBSV67L6,2015.96
1597531864,7/6/2023 17:34,Received Money,184.86,#01R1LSRVS70,2200.82
1597531864,7/12/2023 1:54,Add Money,503.37,#01WDL69AV2E,2704.19
1597531864,7/12/2023 1:59,Cash In,1270,#01XIQOMGXUC,3974.19
1597531864,7/31/2023 4:59,Add Money,713.74,#01LPFEOTPJJ,4687.93
1597531864,8/3/2023 13:32,Cash In,500.47,#011GKKE1Y10,5188.4
1597531864,9/13/2023 8:39,Cash Out,2525.48,#01LLPNNEQLE,2662.92
1597531864,9/16/2023 15:09,Send Money,1212.73,#01KM4HY0N5K,1450.19
1597531864,9/16/2023 21:46,Pay Bill,313.84,#01V0BPI34P4,1136.35
1597531864,9/20/2023 15:31,Cash In,500.93,#01TJEGSDCLH,1637.28
1597531864,9/24/2023 8:19,Request Money,132.09,,1637.28
1597531864,9/24/2023 9:20,Received Money,132.09,#01ME2JOQUXV,1769.37
1597531864,9/25/2023 11:23,Add Money,300.52,#01R2HT6ELY7,2069.89
1597531864,9/25/2023 17:35,Cash In,828.54,#01MWPVNK9QS,2898.43
1597531864,2023-05-08 12.21.12,Cash Out,423.24,#018SVD0V0PX,2475.19
1486429753,9/27/2022 5:00,Send Money,2237.58,#01MAADX3APC,10237.58
1486429753,10/2/2022 2:44,Received Money,255.59,#01XCCRDA581,10493.17
1486429753,10/2/2022 22:53,Cash Out,2686.37,#01308MTYQVR,7806.8
1486429753,10/7/2022 8:01,Add Money,1133.53,#016X3V5JQHU,8940.33
1486429753,10/9/2022 19:57,Add Money,626.01,#01J404NGID4,9566.34
1486429753,10/11/2022 21:01,Received Money,6592.56,#017O4J4NIXT,16158.9
1486429753,10/12/2022 12:56,Fund Transfer,1259.11,#01WK3XP30Q5,14899.79
1486429753,10/13/2022 15:38,Received Money,635.04,#01UMOCP58RV,15534.83
1486429753,10/19/2022 1:24,Cash Out,2570.23,#016GVEZD2QE,12964.6
1486429753,10/19/2022 3:19,Received Money,1800.52,#01629M5FW6W,14765.12
1486429753,9/27/2023 10:41,Received Money,94.88,#015W8BZR17P,14860
1486429753,10/19/2022 19:08,Received Money,7858.8,#01N134D9M9X,22718.8
1486429753,9/27/2023 10:44,Received Money,94.88,#015W8BZR17P,22813.68
1486429753,10/19/2022 22:33,Add Money,2667.05,#01XLAE7I7WA,25480.73
1486429753,10/19/2022 23:19,Make Payment,858.84,#015LH502V5B,24621.89
1486429753,10/20/2022 23:04,Donation,346.8,#01Y6ERYWRY4,24275.09
1486429753,10/23/2022 19:27,Received Money,186.93,#01LFQVTLV16,24462.02
1486429753,10/24/2022 11:02,Fund Transfer,124.91,#01XIOH4ST7S,24337.11
1486429753,10/26/2022 12:07,Received Money,572,#01AIK8H58PH,24909.11
1486429753,10/26/2022 15:10,Make Payment,1044.3,#0102Z3LH0BL,23864.81
1486429753,10/28/2022 17:48,Add Money,1644.5,#01FC5P9JKX8,25509.31
1486429753,10/30/2022 7:21,Donation,125.94,#01I8WZUIKSC,25383.37
1486429753,10/31/2022 7:30,Received Money,4854.85,#01PKILEPEYE,30238.22
1486429753,9/27/2023 10:41,Received Money,38.48,#010ZT9S9JU0,30276.7
1486429753,9/27/2023 10:44,Received Money,38.48,#010ZT9S9JU0,30315.18
1486429753,11/2/2022 1:00,Cash Out,1958.59,#01CS942UA3E,28356.59
1486429753,11/2/2022 5:24,Cash In,291.78,#018UFPACKA3,28648.37
1486429753,11/3/2022 15:23,Request Money,94.88,,28648.37
1486429753,11/3/2022 15:23,Received Money,94.88,#015W8BZR17P,28743.25
1486429753,11/9/2022 4:28,Make Payment,4646.31,#01YA8P5SSU5,24002.06
1486429753,11/13/2022 1:55,Cash Out,3679.97,#016PTJQPP6M,20322.09
1486429753,11/13/2022 16:03,Cash In,1610.59,#01JYL506AKR,21932.68
1486429753,11/14/2022 21:44,Add Money,6237.59,#01XQ969QZNW,28170.27
1486429753,11/16/2022 2:01,Received Money,128.34,#01MZ22TSHLO,28298.61
1486429753,11/20/2022 11:54,Received Money,1788.17,#01ELFSRJM7Y,30086.78
1486429753,11/21/2022 19:59,Cash Out,6000.31,#01UA9SZ91TQ,24086.47
1486429753,11/22/2022 15:59,Received Money,1472.45,#015PTFI57FY,25558.92
1486429753,11/25/2022 0:20,Received Money,38.4,#01OJYFLJS29,25597.32
1486429753,11/29/2022 21:08,Add Money,644.09,#01WAR2FKZ42,26241.41
1486429753,12/4/2022 2:32,Received Money,64.4,#01NQAHDOPM8,26305.81
1486429753,12/6/2022 16:06,Request Money,38.48,,26305.81
1486429753,12/6/2022 16:06,Received Money,38.48,#010ZT9S9JU0,26344.29
1486429753,12/10/2022 6:37,Pay Bill,3574.44,#01QICMJA0BM,22731.37
1486429753,12/10/2022 10:39,Pay Bill,2492.54,#01XEIBDEAMD,20238.83
1486429753,12/10/2022 23:52,Add Money,264.56,#01FO1VD9Q07,20503.39
1486429753,12/11/2022 2:36,Donation,265.13,#01PLZI7VNTX,20238.26
1486429753,9/27/2023 10:41,Received Money,24.97,#01S0O8VAKKG,20263.23
1486429753,9/27/2023 10:44,Received Money,24.97,#01S0O8VAKKG,20288.2
1486429753,12/16/2022 11:42,Received Money,948.11,#01AU5VG786N,21236.31
1486429753,12/16/2022 14:29,Add Money,727.74,#01XMXNH27CT,21964.05
1486429753,12/20/2022 16:23,Donation,100,#01H6IKT6HC6,21864.05
1486429753,12/20/2022 19:54,Cash Out,3904.48,#01HHU6SSATS,17959.57
1486429753,12/23/2022 10:38,Fund Transfer,299.96,#01LK5L7U0SQ,17659.61
1486429753,12/23/2022 15:02,Received Money,1805.68,#01CC0A2NZYH,19465.29
1486429753,12/24/2022 22:28,Pay Bill,1768.65,#012FWDB7UVA,17696.64
1486429753,12/27/2022 4:15,Cash Out,2294.01,#01WYTEQDG94,15402.63
1486429753,12/27/2022 17:26,Fund Transfer,1320.3,#01VOQ46YAI9,14082.33
1486429753,12/29/2022 8:14,Cash In,2707.5,#018DO8BQXOC,16789.83
1486429753,12/30/2022 11:25,Add Money,2485.24,#01XOF94FG0F,19275.07
1486429753,1/4/2023 0:52,Received Money,4813.84,#016RNNX8YQF,24088.91
1486429753,1/4/2023 9:26,Received Money,4459.24,#01J67J0WQ0U,28548.15
1486429753,1/5/2023 4:42,Send Money,3632.35,#01RAYTHF60N,24915.8
1486429753,1/7/2023 18:52,Cash Out,2619.91,#01C3WSMWBCK,22295.89
1486429753,1/8/2023 13:51,Request Money,24.97,,22295.89
1486429753,1/12/2023 21:10,Send Money,938.56,#01V2D2J4WSI,21357.33
1486429753,1/13/2023 17:12,Received Money,1951.93,#013FSCIIG6O,23309.26
1486429753,1/23/2023 6:11,Cash Out,3650.11,#016LAI9MR5R,19659.15
1486429753,1/24/2023 5:30,Add Money,7151.56,#011H7BZIDPQ,26810.71
1486429753,1/28/2023 8:58,Make Payment,2905.68,#013N0DD42A2,23905.03
1486429753,1/29/2023 4:32,Add Money,1093.32,#01066N9KGH0,24998.35
1486429753,2/1/2023 17:39,Pay Bill,1374.86,#01HIL6LYJ9Y,23623.49
1486429753,2/1/2023 18:04,Send Money,747.3,#01QZA9XQIPY,22876.19
1486429753,2/2/2023 1:24,Pay Bill,3367.19,#01XGZIMBKTO,19509
1486429753,2/2/2023 20:35,Send Money,1896.25,#01CRT498MG1,17612.75
1486429753,2/4/2023 22:06,Cash In,6731.12,#01WLMS9A5Q9,24343.87
1486429753,9/27/2023 10:41,Received Money,36.58,#01Q28LPW7XM,24380.45
1486429753,2/5/2023 10:51,Received Money,4929.23,#01EJ98VZWJ0,29309.68
1486429753,9/27/2023 10:44,Received Money,36.58,#01Q28LPW7XM,29346.26
1486429753,2/6/2023 10:11,Cash Out,2196.23,#01HP24YM1HK,27150.03
1486429753,2/6/2023 22:57,Send Money,2321.8,#01URFC66AMN,24828.23
1486429753,2/9/2023 23:49,Add Money,272.92,#010XMZD3Q1M,25101.15
1486429753,2/10/2023 11:52,Fund Transfer,37.96,#011R2F2EYFC,25063.19
1486429753,2/12/2023 7:29,Add Money,179.77,#01ISUDQJGLK,25242.96
1486429753,9/27/2023 10:41,Received Money,74.16,#01HS3Q87R08,25317.12
1486429753,9/27/2023 10:44,Received Money,74.16,#01HS3Q87R08,25391.28
1486429753,2/13/2023 8:29,Cash Out,643.58,#01KI1UR8EKH,24747.7
1486429753,2/14/2023 13:40,Pay Bill,2470.68,#01RFTAG9CWV,22277.02
1486429753,2/16/2023 1:26,Fund Transfer,55.72,#01NYD6Q0GFU,22221.3
1486429753,2/16/2023 12:25,Fund Transfer,289.32,#01A7ZYG8N79,21931.98
1486429753,2/25/2023 11:50,Send Money,2349.79,#01WSIX8VXTV,19582.19
1486429753,2/25/2023 23:42,Pay Bill,3342.05,#015E96R0HE9,16240.14
1486429753,2/26/2023 1:04,Fund Transfer,101.87,#019KSZ22O28,16138.27
1486429753,2/27/2023 6:29,Cash Out,1973.14,#01I66TWK9Y7,14165.13
1486429753,3/1/2023 22:46,Make Payment,2609.08,#01DWN6PAJJI,11556.05
1486429753,3/2/2023 10:56,Fund Transfer,125.42,#01EXLU4RWQT,11430.63
1486429753,3/4/2023 7:41,Request Money,36.58,,11430.63
1486429753,3/5/2023 23:26,Send Money,599.2,#01CMT4SKQIZ,10831.43
1486429753,3/8/2023 8:25,Make Payment,1051.43,#01TD2ZV2DJE,9780
1486429753,3/8/2023 22:35,Pay Bill,876.68,#01NBS73WMMK,8903.32
1486429753,3/9/2023 3:52,Received Money,4797.37,#010UNN6L2YN,13700.69
1486429753,3/9/2023 7:02,Cash Out,3333.8,#01SJQEIWSVV,10366.89
1486429753,3/9/2023 7:34,Fund Transfer,115.11,#01B1Y3X2Q4N,10251.78
1486429753,3/11/2023 4:28,Request Money,74.16,,10251.78
1486429753,3/16/2023 7:16,Cash In,1438.77,#01T8PX5RFZV,11690.55
1486429753,3/17/2023 0:27,Send Money,2571.26,#01G40WJBTFV,9119.29
1486429753,3/19/2023 3:01,Send Money,1231.57,#01Q8N20F26T,7887.72
1486429753,3/20/2023 22:18,Received Money,6940.42,#01VO6D6HHIY,14828.14
1486429753,3/23/2023 8:34,Fund Transfer,216.56,#01K13UNTQN4,14611.58
1486429753,3/23/2023 9:48,Pay Bill,1864.76,#01H282V0Z9C,12746.82
1486429753,3/25/2023 15:15,Cash Out,3970.85,#01DZEHYPAYY,8775.97
1486429753,3/26/2023 4:52,Add Money,2137.55,#01MBH7DWSFP,10913.52
1486429753,3/31/2023 20:47,Cash Out,715.77,#01V80LSPORJ,10197.75
1486429753,4/3/2023 12:22,Received Money,7662.55,#014W0MCPDD0,17860.3
1486429753,4/11/2023 12:04,Send Money,2940.4,#01Q42AHPZZ6,14919.9
1486429753,4/13/2023 1:58,Received Money,2320.8,#01PHK8XQ7Q3,17240.7
1486429753,4/18/2023 7:25,Add Money,5518.27,#01RKN90LJNX,22758.97
1486429753,4/19/2023 15:34,Fund Transfer,352.41,#011674O8T71,22406.56
1486429753,4/22/2023 19:40,Fund Transfer,428.16,#01FT3IRH17N,21978.4
1486429753,4/26/2023 11:38,Cash Out,1442.77,#01BXL66835K,20535.63
1486429753,5/3/2023 8:50,Send Money,3275.96,#01M2JVAPELW,17259.67
1486429753,5/8/2023 3:44,Send Money,3887,#01V80HF9KA3,13372.67
1486429753,5/12/2023 21:32,Received Money,5761.85,#01CXMFXAD4Z,19134.52
1486429753,5/13/2023 17:17,Pay Bill,895.2,#010048U6DJW,18239.32
1486429753,5/15/2023 10:30,Cash Out,3148.9,#01ZKUA40XTB,15090.42
1486429753,5/15/2023 16:44,Send Money,2591.1,#01JUDHYP76N,12499.32
1486429753,5/16/2023 4:03,Cash In,1920.93,#016BXG2QX69,14420.25
1486429753,5/16/2023 8:21,Send Money,1890.94,#012ZU8ULA9U,12529.31
1486429753,5/17/2023 3:25,Make Payment,1403.48,#01NYPDHFBUU,11125.83
1486429753,5/17/2023 23:21,Add Money,3758.35,#01U3B2ECUP1,14884.18
1486429753,5/18/2023 0:13,Pay Bill,1599.49,#014FO8MNEVD,13284.69
1486429753,5/18/2023 14:29,Send Money,507.42,#01F47PCTBOD,12777.27
1486429753,5/19/2023 14:09,Cash Out,2721.79,#01W8DYK11UL,10055.48
1486429753,5/20/2023 5:25,Fund Transfer,307.49,#014ZNWVHJ3M,9747.99
1486429753,5/21/2023 5:46,Send Money,1642.4,#01RX0VYH4YK,8105.59
1486429753,5/21/2023 7:50,Pay Bill,841.65,#01CAKWZIR1R,7263.94
1486429753,5/26/2023 11:04,Pay Bill,1955.34,#01KTK7HI9N9,5308.6
1486429753,5/31/2023 14:51,Cash In,5453.23,#01G31GD5B4J,10761.83
1486429753,6/2/2023 0:20,Cash Out,2546,#01QIPF27GKS,8215.83
1486429753,6/4/2023 22:12,Add Money,5124.09,#0119TPZLD6C,13339.92
1486429753,6/7/2023 16:52,Fund Transfer,189.99,#01YP14A304L,13149.93
1486429753,6/8/2023 5:16,Add Money,2624.73,#01EP1FK9814,15774.66
1486429753,6/8/2023 17:59,Cash Out,2810.22,#01ZD8BLB3W3,12964.44
1486429753,6/9/2023 18:42,Send Money,1104.57,#01LCG6OPBG1,11859.87
1486429753,6/14/2023 5:01,Received Money,6928.25,#0196D3FVM3U,18788.12
1486429753,6/15/2023 1:29,Send Money,1988.75,#01FDD55KM58,16799.37
1486429753,6/16/2023 11:55,Received Money,615.28,#0157LJ4U5IB,17414.65
1486429753,6/16/2023 19:06,Cash Out,664.16,#01XH2H27V8M,16750.49
1486429753,6/17/2023 22:08,Fund Transfer,301.84,#01QYYUEI1JW,16448.65
1486429753,6/21/2023 23:12,Add Money,123.77,#01RAWSA3XOZ,16572.42
1486429753,6/28/2023 15:13,Donation,428.22,#01CZU10EWYP,16144.2
1486429753,7/1/2023 9:45,Add Money,106.33,#01Y0VVBA6GA,16250.53
1486429753,7/2/2023 4:46,Received Money,833.26,#01C7Y1KI9OM,17083.79
1486429753,7/3/2023 8:07,Pay Bill,1793.26,#01VD9649N7A,15290.53
1486429753,7/4/2023 19:28,Add Money,931.45,#01DL4J9NLI7,16221.98
1486429753,7/10/2023 6:55,Add Money,933,#01Y0EWS6DVN,17154.98
1486429753,7/16/2023 14:59,Fund Transfer,173.25,#01VTL78GOFL,16981.73
1486429753,7/17/2023 12:58,Pay Bill,1983.2,#01C9G7288PA,14998.53
1486429753,7/19/2023 16:38,Received Money,3124.86,#01ZWIYQ9KVV,18123.39
1486429753,7/20/2023 2:16,Send Money,2823.02,#01RKRCIMYRY,15300.37
1486429753,7/22/2023 17:14,Pay Bill,50.4,#01V8IJQ30EM,15249.97
1486429753,7/29/2023 0:47,Add Money,4971.6,#01I1ZORY49X,20221.57
1486429753,7/30/2023 5:39,Add Money,1124.76,#01L3Z2T6HCI,21346.33
1486429753,7/31/2023 2:59,Fund Transfer,457.09,#01TNM5U3C1C,20889.24
1486429753,7/31/2023 17:18,Fund Transfer,426.8,#01OLQ2T6PV2,20462.44
1486429753,7/31/2023 20:29,Make Payment,1895.31,#01EQ4KOEYVI,18567.13
1486429753,8/1/2023 7:58,Received Money,566.7,#01CU3BWC7HP,19133.83
1486429753,8/2/2023 10:45,Send Money,2879.46,#01RM4GU81NS,16254.37
1486429753,8/2/2023 14:42,Cash In,4325.47,#011NDU4058W,20579.84
1486429753,8/3/2023 12:53,Add Money,4533.54,#011M5M52FQE,25113.38
1486429753,8/4/2023 0:53,Pay Bill,4880.56,#01BE5IG44SB,20232.82
1486429753,8/12/2023 8:51,Fund Transfer,304.11,#01MIJCZGUZJ,19928.71
1486429753,8/17/2023 21:20,Cash In,1575.21,#0127RBAFWBS,21503.92
1486429753,8/20/2023 8:39,Donation,400,#01H5BTLP3OZ,21103.92
1486429753,8/21/2023 9:27,Pay Bill,2212.06,#01DDPPONCTT,18891.86
1486429753,8/23/2023 7:02,Fund Transfer,327.71,#01GYO1061Y8,18564.15
1486429753,8/23/2023 9:19,Received Money,1515.07,#01ZRGF825AF,20079.22
1486429753,8/24/2023 18:42,Received Money,4969.8,#01QK5VYPZRY,25049.02
1486429753,8/29/2023 21:35,Cash Out,1894.86,#01JD8R8NDF6,23154.16
1486429753,8/31/2023 20:10,Received Money,5427.02,#01KQ2HG94YF,28581.18
1486429753,9/7/2023 14:58,Cash In,4545.95,#010NF6DEIW1,33127.13
1486429753,9/10/2023 11:58,Send Money,3228.15,#01Q8SHZC72R,29898.98
1486429753,9/11/2023 9:21,Send Money,2560.62,#01J8WHEJX17,27338.36
1486429753,9/12/2023 1:31,Cash In,300,#01DJT4G1UGS,27638.36
1486429753,9/12/2023 10:47,Make Payment,4000,#01RJYO76HCO,23638.36
1486429753,9/14/2023 5:24,Send Money,2360.91,#01M7Z2LZ406,21277.45
1486429753,9/14/2023 12:08,Pay Bill,2098.11,#01RIFQVE9AY,19179.34
1486429753,9/18/2023 23:01,Cash Out,1911.94,#01NCAM764VB,17267.4
1486429753,9/24/2023 16:57,Received Money,5170.49,#01ZSU7KMTO0,22437.89
1486429753,9/26/2023 2:13,Received Money,2652.58,#01CEWXP80WK,25090.47
1375318942,10/24/2022 21:29,Send Money,15168.82,#01YCTE3ERVL,4831.18
1375318942,10/25/2022 2:38,Cash In,30415.26,#01QDG0C88AU,35246.44
1375318942,11/3/2022 18:46,Cash Out,16019.73,#01XWDLQ99V1,19226.71
1375318942,11/6/2022 17:32,Send Money,6957.82,#016RX29ZGOB,12268.89
1375318942,7/7/2023 16:09,Cash In,11449.77,#01OQRVDDMAH,23718.66
1375318942,7/15/2023 1:20,Cash In,1872.58,#01QOZ57NBER,25591.24
1375318942,7/18/2023 19:37,Pay Bill,5098.1,#01V3K9SGN3F,20493.14
1375318942,7/20/2023 18:24,Send Money,8320.65,#01D25O5AH25,12172.49
1375318942,9/1/2023 21:39,Cash In,22401.54,#01JG61QJPZ8,34574.03
1375318942,9/4/2023 22:10,Cash Out,28693.85,#01XKZ2HAGCG,5880.18
1864281097,1/1/2023 10:00,Cash In,30000,#01XJ6FFTA36,31200.56
1864281097,1/1/2023 10:00,Request Money,1000,,31200.56
1864281097,1/1/2023 10:00,Received Money,1000,#01XJ6FFTA37,32200.56
1864281097,1/5/2023 14:00,Send Money,26001,#011DNIH0RE3,6199.56
1864281097,1/10/2023 16:00,Pay Bill,2000.46,#01JCT0LQ86M,4199.1
1864281097,1/15/2023 18:00,Make Payment,1000.67,#01KYE5HY319,3198.43
1864281097,3/1/2023 10:00,Cash In,29000.89,#01MLK8SK3QN,32199.32
1864281097,3/5/2023 14:00,Send Money,25000.45,#01GL4Q5RY5W,7199.32
1864281097,3/10/2023 16:00,Pay Bill,1001.23,#01RRV98C7UT,6198.09
1864281097,3/15/2023 18:00,Fund Transfer,1000.9,#01RIHGHMBUZ,5197.19
1864281097,6/1/2023 10:00,Cash In,29001.22,#011V4KSULVA,34198.41
1864281097,6/5/2023 14:00,Send Money,24000.8,#018SCI1KFRC,10197.61
1864281097,6/10/2023 16:00,Send Money,2000.99,#01S41YUCX0F,8196.62
1864281097,6/15/2023 18:00,Pay Bill,1000.1,#01BQK1I1N2U,7196.52
1864281097,9/1/2023 10:00,Received Money,20000,#011U02VWQDK,27196.52
1864281097,4/5/2023 10:00,Request Money,10000,,27196.52
1864281097,4/5/2023 11:00,Received Money,10000,#011U02VWQDZ,37196.52
1864281097,9/5/2023 14:00,Land Tax,36437.08,#01DWFA2KR8P,759.44
1553197286,12/8/2022 3:03,Cash In,27193.32,#012XMPEGC7F,33193.32
1553197286,12/20/2023 12:51,Send Money,10736.36,#014Z73A9TK1,22456.96
1553197286,4/2/2023 12:45,Pay Bill,2780.06,#010LOZW6BW3,19676.9
1553197286,4/19/2023 1:21,Cash In,25479.41,#018CCYKYKAS,45156.31
1553197286,4/23/2023 10:46,Make Payment,26919.81,#0169XXR3Z0M,18236.5
1553197286,4/26/2023 10:46,Send Money,15919.81,#0169XXR3Z0M,2316.69
1798765432,1/11/2022 20:27,Cash In,4639.47,#015471NJ061,14639.47
1798765432,11/29/2022 12:22,Fund Transfer,6472.77,#01HQ99YA325,8166.7
1798765432,8/21/2023 14:13,Cash Out,4276.41,#01IM9MSKUWC,3890.29
1798765432,8/2/2023 7:23,Add Money,10253.47,#01R7JA1ZH7Y,14143.76
1798765432,8/17/2023 15:06,Make Payment,9251.85,#01E6W2J2MBQ,4891.91
1475316942,10/5/2022 2:50,Cash In,2496.77,#01LULHBXE29,28703.35
1475316942,10/7/2022 22:46,Send Money,8596.73,#01D5YEWV50O,20106.62
1475316942,10/8/2022 1:42,Add Money,8533.53,#01C7WJ6VAGR,28640.15
1475316942,10/16/2022 8:42,Send Money,1555.76,#01Y55MSA08L,27084.39
1475316942,10/19/2022 14:41,Send Money,8545.25,#01M5FHNK6O4,18539.14
1475316942,11/13/2022 11:23,Make Payment,13905.47,#019B1YKI4XQ,4633.67
1475316942,11/15/2022 0:01,Cash Out,931.91,#01QWQ6HABRH,3701.76
1475316942,11/19/2022 14:42,Send Money,989.29,#0140H1SU4Q6,2712.47
1475316942,11/20/2022 8:35,Cash Out,2046.63,#01QRWNH4SPV,665.84
1475316942,12/7/2022 19:56,Add Money,1700,#0154JHV6NK3,2365.84
1475316942,12/12/2022 3:08,Cash Out,2202.1,#01DVR1DZZBH,163.74
1475316942,12/15/2022 1:46,Cash In,8434.4,#01KQHPTDSNY,8598.14
1475316942,12/16/2022 2:30,Send Money,1378.51,#01JG7I2AL41,7219.63
1475316942,12/19/2022 21:18,Cash Out,4700.94,#018EEWPQEHY,2518.69
1475316942,1/7/2023 22:46,Pay Bill,1078.83,#01KTFL16UA4,1439.86
1475316942,1/10/2023 17:43,Cash Out,1000,#01KZFBTPFPJ,439.86
1475316942,1/12/2023 20:15,Make Payment,82.19,#01BE6XTQGSW,357.67
1475316942,1/14/2023 17:17,Cash In,15952.56,#01DBYBU8BBO,16310.23
1475316942,1/22/2023 13:43,Send Money,5587.64,#01JXCP8W8WR,10722.59
1475316942,1/25/2023 21:21,Cash Out,293.57,#018WZURVTPT,10429.02
1475316942,1/29/2023 13:40,Send Money,4476.39,#01GQO44G713,5952.63
1475316942,2/3/2023 6:24,Cash Out,5000,#018IT2TBVPD,952.63
1475316942,2/20/2023 4:52,Cash In,5500,#01C88ID60Q5,6452.63
1475316942,2/24/2023 14:07,Make Payment,1419.5,#01Q7PII26LN,5033.13
1475316942,3/8/2023 9:37,Cash Out,380,#01G9AZZJLTK,4653.13
1475316942,3/14/2023 9:10,Land Tax,2252.77,#01IDCC9B69F,2400.36
1475316942,3/18/2023 9:28,Mobile Recharge,197.31,#01T36YKFOHJ,2203.05
1475316942,9/27/2023 10:41,Received Money,471.32,#01ZKVTYL89V,2674.37
1475316942,9/27/2023 10:44,Received Money,471.32,#01ZKVTYL89V,3145.69
1475316942,3/25/2023 1:25,Cash In,4722.67,#01FC5MEGDA7,7868.36
1475316942,4/2/2023 2:39,Land Tax,4624.46,#01TFBC811QH,3243.9
1475316942,4/28/2023 14:46,Make Payment,1000,#017J8MS3I6J,2243.9
1475316942,5/7/2023 6:49,Cash In,8000,#01DNL62TXB2,10243.9
1475316942,5/23/2023 4:08,Mobile Recharge,83.93,#015M046883F,10159.97
1475316942,5/23/2023 21:34,Send Money,2521.1,#01EN6TTKNVT,7638.87
1475316942,5/26/2023 21:14,Cash Out,654,#01NR8R0ZCQK,6984.87
1475316942,5/28/2023 6:14,Add Money,10220,#01VIHOQBSYW,17204.87
1475316942,6/12/2023 4:12,Cash Out,7924.22,#0137HTPX43L,9280.65
1475316942,6/16/2023 4:11,Send Money,829.14,#01F0T0V7X6P,8451.51
1475316942,6/18/2023 3:52,Cash Out,200,#01BWFSM6OGQ,8251.51
1475316942,6/23/2023 11:05,Send Money,508.14,#01X10TGR8FC,7743.37
1475316942,7/4/2023 17:35,Cash Out,1211.98,#011OZSBY0VH,6531.39
1475316942,7/27/2023 0:50,Donation,4149.13,#010QCUFQU29,2382.26
1475316942,7/29/2023 3:08,Make Payment,1043.01,#01RB7SHYM7I,1339.25
1475316942,8/10/2023 6:24,Mobile Recharge,151.2,#01VP377QEX5,1188.05
1475316942,8/21/2023 0:09,Cash In,2340.12,#01FWR65CLHR,3528.17
1475316942,8/27/2023 17:10,Send Money,2085.28,#01CTLRCQM0Z,1442.89
1475316942,8/29/2023 8:28,Request Money,471.32,,1442.89
1475316942,8/31/2023 9:28,Cash In,3896.72,#01BMKN9KB3Q,5339.61
1475316942,9/6/2023 11:28,Add Money,5000,#01R1J6TZZ42,10339.61
1475316942,9/20/2023 4:53,Cash Out,8244.67,#01099QV0UFZ,2094.94
1475316942,9/20/2023 11:54,Make Payment,851.57,#01N09ZFBW85,1243.37
1475316942,9/26/2023 12:45,Cash Out,1200,#013DKAM2IAV,43.37
1897549864,3/7/2022 13:25,Cash In,6251.9,#0164URYR0LL,26251.9
1897549864,4/21/2022 16:51,Send Money,4831.17,#013QQ2TVOCD,21420.73
1897549864,4/23/2022 5:56,Make Payment,20049.72,#01V9HZYVVGC,1371.01
1897549864,1/18/2023 23:09,Cash In,12337.12,#01HK3YZT6AW,13708.13
1897549864,1/23/2023 6:02,Send Money,4200.78,#01U8WLQ8CW7,9507.35
1897549864,2/2/2023 23:08,Cash Out,5247.97,#01HZG1RCBMN,4259.38
1554311669,5/24/2023 3:04,Cash In,100,#012JCI15SS,557.48
1554311669,5/29/2023 2:51,Cash Out,112.7,#0133JCI14SS,444.78
1554311669,4/14/2023 16:28,Mobile Recharge,19.1,#01G0MJWG1GC,425.68
1554311669,11/9/2022 11:19,Mobile Recharge,38.14,#01ZKS2YHF7R,387.54
1554311669,8/17/2023 11:54,Received Money,469.11,#01B7201IFSQ,856.65
1554311669,11/2/2022 21:28,Cash Out,25.12,#01OXBVSDEX6,831.53
1554311669,6/20/2023 2:04,Cash In,102.66,#01P3KYVQ693,934.19
1554311669,3/15/2023 12:12,Make Payment,87.18,#01T0L4Y8POY,847.01
1554311669,10/2/2022 6:40,Cash Out,169.51,#01RX1R5DIFY,677.5
1554311669,1/19/2023 0:12,Send Money,189.66,#017KEGZQAHY,487.84
1554311669,9/20/2023 16:33,Add Money,415.03,#010Z0HQ5PFG,902.87
1554311669,3/25/2023 12:16,Send Money,144.59,#01GTUUVLBNN,758.28
1554311669,5/14/2023 23:47,Pay Bill,259.65,#011HFZG9KLJ,498.63
1554311669,8/24/2023 16:42,Cash In,243.59,#01498ACDB1W,742.22
1554311669,12/27/2022 7:18,Pay Bill,85.74,#01SSZH32GBH,656.48
1554311669,2/15/2023 18:26,Cash Out,195.19,#01LKXVYWVW6,461.29
1554311669,8/7/2023 6:01,Send Money,104.09,#01J49QW016X,357.2
1554311669,11/21/2022 20:26,Cash Out,94.41,#01ZEQCK4D6E,262.79
1554311669,2/19/2023 18:40,Received Money,343.19,#011LSFO2N5X,605.98
1554311669,7/4/2023 13:19,Send Money,112.2,#01X13KV6PZZ,493.78
1554311669,1/2/2023 19:24,Cash Out,183.62,#015GJMT24AV,310.16
1554311669,3/31/2023 11:19,Cash In,131.99,#016QSNJLQLT,442.15
1554311669,4/8/2023 14:00,Cash Out,121.12,#01IGSVRYEYS,321.03
1554311669,7/29/2023 15:10,Send Money,109.08,#011YMCY2DW8,211.95
1554311669,3/10/2023 18:30,Cash In,364.73,#01E236Q2S7G,576.68
1554311669,4/19/2023 1:00,Cash Out,184.62,#01KG2FDPDKV,392.06
1554311669,10/26/2022 23:16,Cash In,237.63,#01IL9S08WJ5,629.69
1554311669,8/7/2023 1:03,Make Payment,163.89,#01AVGJP8MS6,465.8
1554311669,1/24/2023 16:02,Cash In,400.99,#01E017BL6PB,866.79
1554311669,5/1/2023 8:17,Pay Bill,177.35,#01TQ2UXZEBE,689.44
1554311669,11/7/2022 4:24,Pay Bill,97.88,#0113L4UNFBA,591.56
1554311669,2/16/2023 14:36,Cash Out,102.78,#01JXXEEOV2A,488.78
1554311669,3/3/2023 21:19,Cash Out,85.56,#01J096S623C,403.22
1554311669,9/13/2023 3:01,Cash In,257.56,#01TJF7X3KI3,660.78
1554311669,8/15/2023 10:24,Pay Bill,56.12,#01YD5TK5P3J,604.66
1554311669,1/4/2023 16:06,Request Money,203.25,,604.66
1554311669,1/5/2023 16:06,Received Money,203.25,#013SYIGC8N2,807.91
1554311669,12/24/2022 21:43,Add Money,463.14,#01BQJ0UPPOR,1271.05
1554311669,4/6/2023 4:34,Mobile Recharge,8.13,#01M5GDJNWQE,1262.92
1554311669,9/12/2023 12:12,Pay Bill,85.25,#01HF6EMOZ63,1177.67
1554311669,11/21/2022 20:06,Add Money,238.2,#01WBNF83WWX,1415.87
1554311669,9/9/2023 16:47,Cash In,242.66,#01FGBFVAUPT,1658.53
1554311669,10/4/2022 16:00,Cash In,141.32,#01SM1JC31XC,1799.85
1554311669,12/16/2022 20:39,Send Money,182.03,#015BMCFSYK5,1617.82
1554311669,6/15/2023 23:44,Send Money,118.46,#017RP51TE13,1499.36
1554311669,8/18/2023 18:13,Cash In,276.68,#01DLMWHM7VW,1776.04
1554311669,1/30/2023 3:57,Mobile Recharge,36.11,#017UMJXBB2U,1739.93
1554311669,4/25/2023 20:26,Pay Bill,147.1,#01GD1KUZM70,1592.83
1554311669,10/15/2022 3:49,Cash Out,109.33,#0136CCOL773,1483.5
1554311669,6/3/2023 16:54,Add Money,406.84,#01865JXSSY0,1890.34
1554311669,4/12/2023 21:43,Send Money,56.08,#01B98AIEMYI,1834.26
1554311669,9/19/2023 12:55,Cash Out,101.13,#01W5BOTEJEI,1733.13
1554311669,2/20/2023 21:44,Send Money,86.82,#01I5P11FRPS,1646.31
1554311669,5/29/2023 22:58,Cash Out,130.79,#01NQX79Y9GH,1515.52
1554311669,12/17/2022 22:34,Pay Bill,100.38,#013S56U1UN7,1415.14
1554311669,2/21/2023 21:12,Cash Out,162.28,#01G5NLDNL9S,1252.86
1554311669,5/10/2023 8:04,Cash In,347.97,#017BG5MHWE4,1600.83
1554311669,8/8/2023 23:16,Cash In,400.18,#019BATWMGIU,2001.01
1554311669,2/13/2023 19:28,Add Money,398.53,#01Y9N0YHKG4,2399.54
1554311669,9/27/2022 6:01,Pay Bill,205.4,#01N3I0ODIZ5,2194.14
1554311669,6/14/2023 8:01,Cash Out,89.93,#0132QX3IFS8,2104.21
1554311669,5/8/2023 15:59,Cash In,417.94,#01XFO03HVAP,2522.15
1554311669,3/10/2023 13:11,Pay Bill,61.85,#01SY3F6RXBX,2460.3
1554311669,8/3/2023 9:55,Mobile Recharge,45.21,#01VQVH4Y35F,2415.09
1554311669,11/2/2022 7:11,Make Payment,126.4,#01S8YIGWFAN,2288.69
1554311669,3/10/2023 11:56,Cash Out,180.18,#01Z4PKGM4V9,2108.51
1554311669,1/25/2023 1:56,Send Money,130.64,#01D04CTB4SX,1977.87
1554311669,8/18/2023 11:45,Cash Out,136.12,#018O0IIHGL8,1841.75
1554311669,12/17/2022 1:10,Pay Bill,567.22,#01ISWSYLOXQ,1274.53
1554311669,2/5/2023 5:49,Pay Bill,274.66,#01N9Z02J1DU,999.87
1554311669,10/28/2022 5:47,Pay Bill,99.96,#01MJX0FSMIM,899.91
1554311669,1/9/2023 3:15,Received Money,282,#01X426Y10U7,1181.91
1554311669,11/26/2022 2:40,Cash Out,87.37,#01IVD9MWIQN,1094.54
1554311669,10/18/2022 3:08,Send Money,70.12,#01IECLW57BS,1024.42
1554311669,1/31/2023 20:53,Cash Out,106.46,#013MR82KSSR,917.96
1554311669,2/7/2023 8:05,Send Money,578.66,#015TMKSIDED,339.3
1554311669,5/6/2023 22:05,Add Money,458.99,#01S3IRCTP2L,798.29
1554311669,9/21/2023 7:11,Received Money,359.3,#01FUC6D86T0,1157.59
1554311669,5/23/2023 2:41,Cash Out,177.29,#018L8VWPISG,980.3
1554311669,12/26/2022 13:45,Cash Out,151.38,#01QIOV0LW3O,828.92
1554311669,2/26/2023 14:56,Mobile Recharge,24.1,#01VVALVSCL3,804.82
1554311669,6/7/2023 23:29,Add Money,151.36,#01NC8QZHXIA,956.18
1554311669,5/14/2023 14:22,Request Money,145.02,,956.18
1554311669,5/14/2023 14:42,Received Money,145.02,#01ZZ2HXR4AU,1101.2
1554311669,6/26/2023 22:26,Cash Out,164.07,#01YLNYAYH1B,937.13
1554311669,7/28/2023 10:21,Add Money,225.37,#01ITMXJF0LS,1162.5
1554311669,2/21/2023 2:46,Pay Bill,171.11,#01SUOLUKTE5,991.39
1554311669,6/7/2023 10:44,Cash In,243.65,#01LWHD0MYA5,1235.04
1554311669,3/11/2023 20:36,Cash In,292.84,#01S0GHBFTGO,1527.88
1554311669,10/15/2022 3:34,Pay Bill,112.29,#01D44IOV4PC,1415.59
1554311669,4/21/2023 9:11,Donation,80.41,#01OO8SAWH8Z,1335.18
1554311669,12/2/2022 17:25,Cash In,275.15,#0134S7WVLJR,1610.33
1554311669,10/21/2022 5:04,Cash In,223.09,#01Z51GOWGKU,1833.42
1554311669,5/27/2023 20:14,Add Money,111.18,#01H14JYAI0X,1944.6
1554311669,9/20/2023 7:28,Add Money,382.36,#018ZY6VYQS7,2326.96
1554311669,7/6/2023 2:06,Request Money,296,,2326.96
1554311669,6/19/2023 11:47,Request Money,268.64,,2326.96
1554311669,8/21/2023 17:56,Received Money,125.52,#01VLOIE1D1W,2452.48
1554311669,7/18/2023 15:54,Request Money,286.89,,2452.48
1554311669,11/11/2022 7:41,Make Payment,189.09,#01ZHLCQUO3W,2263.39
1554311669,8/19/2023 8:59,Cash Out,177.17,#01VN0T83564,2086.22
1554311669,1/20/2023 19:34,Send Money,89.8,#01QQSHND9PI,1996.42
1554311669,3/5/2023 14:36,Received Money,64.22,#01OZQQHHJGW,2060.64
1554311669,2/12/2023 1:12,Cash In,196.38,#0147HKPAKME,2257.02
1554311669,9/12/2023 17:17,Cash Out,538.35,#014R820AOWV,1718.67
1554311669,10/17/2022 15:57,Mobile Recharge,30.52,#01HTDNKXPZF,1688.15
1554311669,10/10/2022 5:13,Cash In,449.88,#01IBK6IJ16W,2138.03
1554311669,9/16/2023 13:35,Mobile Recharge,33.09,#01IYCA9VI9E,2104.94
1554311669,10/1/2022 11:02,Received Money,250.18,#01RJX6M2GCD,2355.12
1554311669,10/30/2022 2:17,Cash Out,199.34,#010UUKKR32I,2155.78
1554311669,9/28/2022 0:12,Send Money,168.41,#01XIGOVXN6I,1987.37
1554311669,10/4/2022 1:59,Cash Out,980.03,#01R8J5NP39E,1007.34
1554311669,10/21/2022 6:08,Received Money,121.38,#017PPSLHNLJ,1128.72
1554311669,5/29/2023 6:37,Pay Bill,139.44,#01UPZXC2L71,989.28
1554311669,7/19/2023 23:13,Make Payment,114.26,#01QN13EOH9J,875.02
1554311669,4/14/2023 1:57,Pay Bill,75.66,#01TENSY0VTK,799.36
1554311669,1/18/2023 14:29,Cash Out,104.64,#010B3KRHBZA,694.72
1554311669,10/16/2022 8:26,Mobile Recharge,48.35,#01XKYEM7DR1,646.37
1554311669,5/30/2023 23:08,Mobile Recharge,36.34,#01UWV8LF4N4,610.03
1554311669,3/28/2023 4:02,Pay Bill,178.53,#01SM2P3BZIJ,431.5
1554311669,12/16/2022 5:55,Cash Out,183.95,#01W8LW7A8ML,247.55
1554311669,11/6/2022 8:24,Received Money,1136.29,#01RYCJ2KUIR,1383.84
